########################
#.##.#.#######.........#
###..###...............#
##........#......#####.#
#......#..####......##.#
###..###..######.......#
#.#..#....###..##..###.#
###.##.#.##........#.#.#
##......##...###....##.#
##.....#####...........#
#......................#
#...........@..........#
#......................#
#........###......######
#.....###....##....#####
########################